"a" = (/turf/space,/area)
"b" = (/turf/unsimulated/mineral/random,/area/mine/unexplored)
"c" = (/turf/unsimulated/mineral/random/high_chance,/area/mine/unexplored)
"d" = (/turf/unsimulated/mineral/random/high_chance_clown,/area/mine/unexplored)

(1,1,1) = {"
aaaabbbaaa
abbbcccbba
bcccdddcba
bbccddddcb
aabbcccccb
aaaabbbbba
"}
