"a" = (/turf/space,/area)
"b" = (/turf/unsimulated/mineral/random,/area/mine/unexplored)
"c" = (/turf/unsimulated/mineral/random/high_chance,/area/mine/unexplored)
"d" = (/turf/unsimulated/mineral/random/high_chance_clown,/area/mine/unexplored)
"e" = (/turf/unsimulated/mineral/silver,/area/mine/unexplored)
"f" = (/turf/unsimulated/mineral/clown,/area/mine/unexplored)
"g" = (/turf/unsimulated/mineral/uranium,/area/mine/unexplored)
"h" = (/turf/unsimulated/mineral/telecrystal,/area/mine/unexplored)
"i" = (/turf/unsimulated/mineral/phazon,/area/mine/unexplored)
"j" = (/turf/unsimulated/mineral/diamond,/area/mine/unexplored)
"k" = (/turf/unsimulated/mineral/gold,/area/mine/unexplored)
"l" = (/turf/unsimulated/mineral/plasma,/area/mine/unexplored)

(1,1,1) = {"
aaaaabbbbbaaaaaa
aaaaabcccbbaaaaa
aaaabbcdccbbbbaa
aabbbccddceccbba
abbcccddddddccba
bbccddddfddddcbb
bgcddddddddddccb
bcddhdddddddddcb
bcddddddddidddcb
bcdddddddddddjcb
bcdddddddddcccbb
bckcddddddccbbba
bbbccddddccbbaaa
aabbccddccbballa
aaabbccccbbaalaa
aaaabbbbbbaaaaaa
"}
